2311441132
2000000002
2000000002
2000000002
2000000002
2000000002
2000000002
2000000002
2000000002
2111111112