2331111332
2000000002
2000000002
2000000002
2000000002
2000000002
2000000002
2000000002
2000000002
2111111112